{
    "level_1": [
    {
        
        "map": [
            [1,1,1,1,1,1,1,1,1,1,1],
            [1,0,0,0,0,0,0,0,0,0,1],
            [1,0,0,1,1,0,0,0,0,1,1],
            [1,0,0,0,0,0,0,0,0,1],
            [1,0,0,0,0,0,0,0,0,1],
            [1,0,1,0,0,0,0,1,1,1],
            [1,0,0,0,0,0,0,1],
            [1,1,1,1,1,1,1,1]
        ],

        "enemy": [{"Type": "PhaseReaper", "x": 4, "y": 4}],
        "nextLevel": "level_2"
    },
    {

        "map": [
            [1,1,1,1,1,1,1,1,1,1],
            [1,0,0,0,1,1,1,0,0,1],
            [1,0,0,0,0,1,0,0,0,1,1],
            [1,0,0,0,0,0,0,0,0,0,1],
            [1,0,0,0,0,0,0,0,0,1,1],
            [1,0,1,1,0,0,0,0,0,1],
            [1,0,1,0,0,0,0,1,1,1],
            [1,1,1,1,1,1,1,1]
        ],

        "enemy": [{"Type": "PhaseReaper", "x": 3, "y": 4}],
        "nextLevel": "level_2"
    },
    {

        "map": [
            [1,1,1,1,1,1,1,1],
            [1,0,0,0,0,0,1,1],
            [1,0,0,0,0,0,0,1],
            [1,1,0,0,0,0,0,1],
            [1,1,1,0,0,0,0,1],
            [1,1,1,0,0,0,0,1],
            [1,0,0,0,0,0,1,1],
            [1,1,1,1,1,1,1,1]
        ],

        "enemy": [{"Type": "Ghost", "x": 3, "y": 6}, {"Type": "Ghost", "x": 5, "y": 4}],
        "nextLevel": "level_2"
    }
    ],
    "level_2": [
    {
       
        "map": [
            [1,1,1,1,1,1,1,1],
            [1,0,0,0,0,0,0,1],
            [1,0,0,0,0,0,0,1],
            [1,0,0,0,0,0,0,1],
            [1,0,0,0,0,0,0,1],
            [1,0,1,0,0,0,0,1],
            [1,0,0,0,0,0,0,1],
            [1,1,1,1,1,1,1,1]
        ],

        "enemy": [{"Type": "Devil", "x": 4, "y": 4}],
        "nextLevel": "level_3"
    },
    {
        
        "map": [
            [1,1,1,1,1,1,1,1],
            [1,0,0,0,0,0,0,1],
            [1,0,0,0,0,0,0,1],
            [1,0,0,0,0,0,0,1],
            [1,0,0,0,0,0,0,1],
            [1,0,1,1,0,0,0,1],
            [1,0,0,0,0,0,0,1],
            [1,1,1,1,1,1,1,1]
        ],

        "enemy": [{"Type": "Devil", "x": 4, "y": 4}],
        "nextLevel": "level_3"
    },
    {
     
        "map": [
            [1,1,1,1,1,1,1,1],
            [1,0,0,0,0,0,0,1],
            [1,0,0,0,0,0,0,1],
            [1,0,0,0,0,0,0,1],
            [1,0,0,0,0,0,0,1],
            [1,0,1,1,1,0,0,1],
            [1,0,0,0,0,0,0,1],
            [1,1,1,1,1,1,1,1]
        ],

        "enemy": [{"Type": "Devil", "x": 4, "y": 4}, {"Type": "Ghost", "x": 3, "y": 4}],
        "nextLevel": "level_3"
    }
    ],
    "level_3": [
    {
       
        "map": [
            [1,1,1,1,1,1,1,1],
            [1,0,0,0,0,0,0,1],
            [1,0,0,0,0,0,0,1],
            [1,0,0,0,0,0,0,1],
            [1,0,0,0,0,0,0,1],
            [1,0,1,0,0,0,0,1],
            [1,0,0,0,0,0,0,1],
            [1,1,1,1,1,1,1,1]
        ],

        "enemy": [{"Type": "Devil", "x": 4, "y": 4}],
        "nextLevel": "level_4"
    },
    {
        
        "map": [
            [1,1,1,1,1,1,1,1],
            [1,0,0,0,0,0,0,1],
            [1,0,0,0,0,0,0,1],
            [1,0,0,0,0,0,0,1],
            [1,0,0,0,0,0,0,1],
            [1,0,1,1,0,0,0,1],
            [1,0,0,0,0,0,0,1],
            [1,1,1,1,1,1,1,1]
        ],

        "enemy": [{"Type": "Devil", "x": 4, "y": 4}],
        "nextLevel": "level_4"
    },
    {
     
        "map": [
            [1,1,1,1,1,1,1,1],
            [1,0,0,0,0,0,0,1],
            [1,0,0,0,0,0,0,1],
            [1,0,0,0,0,0,0,1],
            [1,0,0,0,0,0,0,1],
            [1,0,1,1,1,0,0,1],
            [1,0,0,0,0,0,0,1],
            [1,1,1,1,1,1,1,1]
        ],

        "enemy": [{"Type": "Devil", "x": 4, "y": 4}, {"Type": "Ghost", "x": 3, "y": 4}],
        "nextLevel": "level_4"
    }
    ],
    "level_4": [
    {
       
        "map": [
            [1,1,1,1,1,1,1,1],
            [1,0,0,0,0,0,0,1],
            [1,0,0,0,0,0,0,1],
            [1,0,0,0,0,0,0,1],
            [1,0,0,0,0,0,0,1],
            [1,0,1,0,0,0,0,1],
            [1,0,0,0,0,0,0,1],
            [1,1,1,1,1,1,1,1]
        ],

        "enemy": [{"Type": "Devil", "x": 4, "y": 4}],
        "nextLevel": "level_5"
    },
    {
        
        "map": [
            [1,1,1,1,1,1,1,1],
            [1,0,0,0,0,0,0,1],
            [1,0,0,0,0,0,0,1],
            [1,0,0,0,0,0,0,1],
            [1,0,0,0,0,0,0,1],
            [1,0,1,1,0,0,0,1],
            [1,0,0,0,0,0,0,1],
            [1,1,1,1,1,1,1,1]
        ],

        "enemy": [{"Type": "Devil", "x": 4, "y": 4}],
        "nextLevel": "level_5"
    },
    {
     
        "map": [
            [1,1,1,1,1,1,1,1],
            [1,0,0,0,0,0,0,1],
            [1,0,0,0,0,0,0,1],
            [1,0,0,0,0,0,0,1],
            [1,0,0,0,0,0,0,1],
            [1,0,1,1,1,0,0,1],
            [1,0,0,0,0,0,0,1],
            [1,1,1,1,1,1,1,1]
        ],

        "enemy": [{"Type": "Devil", "x": 4, "y": 4}, {"Type": "Ghost", "x": 3, "y": 4}],
        "nextLevel": "level_5"
    }
    ],
    "level_5": [
    {
       
        "map": [
            [1,1,1,1,1,1,1,1],
            [1,0,0,0,0,0,0,1],
            [1,0,0,0,0,0,0,1],
            [1,0,0,0,0,0,0,1],
            [1,0,0,0,0,0,0,1],
            [1,0,1,0,0,0,0,1],
            [1,0,0,0,0,0,0,1],
            [1,1,1,1,1,1,1,1]
        ],

        "enemy": [{"Type": "Devil", "x": 4, "y": 4}],
        "nextLevel": "none"
    },
    {
        
        "map": [
            [1,1,1,1,1,1,1,1],
            [1,0,0,0,0,0,0,1],
            [1,0,0,0,0,0,0,1],
            [1,0,0,0,0,0,0,1],
            [1,0,0,0,0,0,0,1],
            [1,0,1,1,0,0,0,1],
            [1,0,0,0,0,0,0,1],
            [1,1,1,1,1,1,1,1]
        ],

        "enemy": [{"Type": "Devil", "x": 4, "y": 4}],
        "nextLevel": "none"
    },
    {
     
        "map": [
            [1,1,1,1,1,1,1,1],
            [1,0,0,0,0,0,0,1],
            [1,0,0,0,0,0,0,1],
            [1,0,0,0,0,0,0,1],
            [1,0,0,0,0,0,0,1],
            [1,0,1,1,1,0,0,1],
            [1,0,0,0,0,0,0,1],
            [1,1,1,1,1,1,1,1]
        ],

        "enemy": [{"Type": "Devil", "x": 4, "y": 4}, {"Type": "Ghost", "x": 3, "y": 4}],
        "nextLevel": "none"
    }
    ]
}