{
    "level_1": [
    {
        "id": 1,

        "map": [
            [1,1,1,1,1,1,1,1],
            [1,0,0,0,0,0,0,1],
            [1,0,0,0,0,0,0,1],
            [1,0,0,0,0,0,0,1],
            [1,0,0,0,0,0,0,1],
            [1,0,1,0,0,0,0,1],
            [1,0,0,0,0,0,0,1],
            [1,1,1,1,1,1,1,1]
        ],

        "enemy": [{"Type": "Devil", "x": 4, "y": 4}, {"Type": "Devil", "x": 3, "y": 4}],
        "nextLevel": "level_2"
    },
    {
        
        "id": 2,

        "map": [
            [1,1,1,1,1,1,1,1],
            [1,0,0,0,0,0,0,1],
            [1,0,0,0,0,0,0,1],
            [1,0,0,0,0,0,0,1],
            [1,0,0,0,0,0,0,1],
            [1,0,1,1,0,0,0,1],
            [1,0,0,0,0,0,0,1],
            [1,1,1,1,1,1,1,1]
        ],

        "enemy": [{"Type": "Devil", "x": 4, "y": 4}, {"Type": "Devil", "x": 3, "y": 4}],
        "nextLevel": "level_2"
    },
    {
        
        "id": 3,

        "map": [
            [1,1,1,1,1,1,1,1],
            [1,0,0,0,0,0,0,1],
            [1,0,0,0,0,0,0,1],
            [1,0,0,0,0,0,0,1],
            [1,0,0,0,0,0,0,1],
            [1,0,1,1,1,0,0,1],
            [1,0,0,0,0,0,0,1],
            [1,1,1,1,1,1,1,1]
        ],

        "enemy": [{"Type": "Devil", "x": 4, "y": 4}, {"Type": "Devil", "x": 3, "y": 4}],
        "nextLevel": "level_2"
    }
    ],
    "level_2": [
    {
        "id": 1,

        "map": [
            [1,1,1,1,1,1,1,1],
            [1,0,0,0,0,0,0,1],
            [1,0,0,0,0,0,0,1],
            [1,0,0,0,0,0,0,1],
            [1,0,0,0,0,0,0,1],
            [1,0,1,0,0,0,0,1],
            [1,0,0,0,0,0,0,1],
            [1,1,1,1,1,1,1,1]
        ],

        "enemy": [{"Type": "Devil", "x": 4, "y": 4}],
        "nextLevel": "none"
    },
    {
        
        "id": 2,

        "map": [
            [1,1,1,1,1,1,1,1],
            [1,0,0,0,0,0,0,1],
            [1,0,0,0,0,0,0,1],
            [1,0,0,0,0,0,0,1],
            [1,0,0,0,0,0,0,1],
            [1,0,1,1,0,0,0,1],
            [1,0,0,0,0,0,0,1],
            [1,1,1,1,1,1,1,1]
        ],

        "enemy": [{"Type": "Devil", "x": 4, "y": 4}],
        "nextLevel": "none"
    },
    {
        
        "id": 3,

        "map": [
            [1,1,1,1,1,1,1,1],
            [1,0,0,0,0,0,0,1],
            [1,0,0,0,0,0,0,1],
            [1,0,0,0,0,0,0,1],
            [1,0,0,0,0,0,0,1],
            [1,0,1,1,1,0,0,1],
            [1,0,0,0,0,0,0,1],
            [1,1,1,1,1,1,1,1]
        ],

        "enemy": [{"Type": "Devil", "x": 4, "y": 4}, {"Type": "Devil", "x": 3, "y": 4}],
        "nextLevel": "none"
    }
    ]
}